####################################################################
# #    @   X       ##                  ##     #   ###       #      #
#     ########      #   ####     ##     ###   ##       ###      #  #
# #          ###        #      ######          #         ##        #
# ###### ##    ####### #   #         ###    #######    ##        ###
#    #   ###    #       ##    ########               ###           #
#### # ##      #     ####   ##          ###  ###             ####  #
#    # #    ####      #     #     U       ###   ####### ######     #
#  #    ##       #    #                ####                      ###
# ####   #######  ######     #####    #        ## ##    #          #
#    ###  #             #####         #########    ############  ###
####      #    ####    ##     ###    ###         ###               #
#    ######## ##   ####              #         ###           #######
# #####        ##     ####   ######   ##   # ##   ###     #        #
# #     ###### #         ####     #     ##    ##     #####     #####
# #        #   ###   ##   ##      ###           ##       ###       #
#     #   ##        ##        ##         #  ##       ##        #   #
####################################################################
